WW.WW.W.W
WW......W
...WW.WW.
.W...W.W.
.WSW.....
WWWWWWWW.
.......W.
.WWWWW.W.
.W...W.W.
.W.WEW.W.
.W.WWW.W.
.W.....W.
.WWWWWWW.
.........
WWWWWWWW.
WWWWW....